11111111111111111111111
1C0000000000010000000C1
1C000000000000000CC0001
100EC0000000000001C0001
10C0C000000000C00000001
100000000000000C00000C1
10000000000000000000001
1000000C0C0000000000001
10000000000000000000001
100C0000000P00C00000001
10000000000000000000001
1C000000000C00000000001
100000000000000C000C001
10000000000000000000001
10000000000C00000000001
10000000000000001010001
10000000000000000CC0001
1C00000001C0000000CC001
1000C000000000000000001
100000000000000C0000001
10000000000000000000001
11111111111111111111111