11111111111111111111
10C0C0C0000100C00001
10000000110000000101
10010C00C0000C100001
10010C010C100C000001
1000C000000000000001
11C000C0000C00001001
10CC00C010C1C1C00001
10000000000001000011
100000100C000C000001
101C0000001000C00C01
1000C0000C00000E0001
1000000CCC0000000001
1000000010000000C001
10000000000000000001
1100000C0010000000C1
10000P00000110000001
11110100000000000001
1000C00C000000000001
1000C00C000000000001
10000000000000000001
11111111111111111111