111111111111111111111
10000010000C001C01C01
100100000100100001001
100000110000100000111
100110010C01C0001CC01
11000C000000000010101
100100000001100000001
10101000E000000010011
101000000000100000001
1100C1000100000P00001
1000C0101000000110001
110000000001000C00001
100000111000010C00101
110010000000000100001
100C000001100C0010001
1001C0011000C00010001
101100000100000000001
100000000000000000001
111111111111111111111