11111111111
100C0C00001
1100CC00C01
1010C11C001
100C00100C1
10000CC0001
10010C10001
1000C0000C1
1000000C0C1
1000001P001
1001C0C0001
100000C10C1
1C001000001
1100000C001
100C11C1001
100110000C1
10000000C01
100000C0E01
10000000011
10000000001
11111111111