1111111111111111
100000000C000001
100000P000000001
10000000000C0001
1111111111111111
