10000011111111111111111
11110C00000000000000011
10000001110000001100001
11100E00C000000P1110001
111C0000000C00000111001
11111111111111111111111
