11111111111111111111
1111100000000000111111
11100000000000001111
11111111111111111111
