1111111111111
11000011C0001
1000E000000P1
1000R00000001
1111111111111
