111111111111
111000000E11
110001110001
1P000C000001
111111111111
