




11111111111111
10000000000001
100000P1100001
10000000C000C1
110E0001100001
11111111111111
